NO  ./assets/textures/wall_N.xpm
SO  ./assets/textures/wall_S.xpm
WE  ./assets/textures/wall_W.xpm
EA  ./assets/textures/wall_E.xpm

F 255,0,0
C 255,255,254  

               1111111111                        1111111111111111111111111111111111111111111111
               1000000001                        100000000000000000000000000000000000000000000S1   
               1000000001                        10000000000000000000000000000000000000000000001   
               1000000001                        1000000000000000000000000000000000000000000001    
               1000000001                        1000000000000000000000000000000000000000000001    
               1000000001                        1000000000000000000000000000000000000000000001    
               1000000001                        1000000000000000000000000000000000000000000001    
               1000000001                        1000000000111111111111111111111111110000000001
               1000000001                        10000000001                        1000000001     
               1000000001                        10000000001                        1000000001     
               1000000001                        10000000001                       10000000001     
               1000000001                        10000000001                       10000000001     
               1000000001                        10000000001                       1000000001      
               1000000001                        10000000001                       1000000001      
               1000000001                        10000000001                       1000000001      
               1000000001                        10000000001                      10000000001      
               1000000001                        10000000001                      10000000001      
               1000000001                        10000000001                      1000000001       
               1000000001                        10000000001                      1000000001       
               1000000001                        10000000001                      1000000001       
               1000000001                        10000000001                     10000000001       
               1000000001                        10000000001                     10000000001       
               1000000001                        10000000001                     1000000001        
               1000000001                        10000000001                     1000000001        
               1000000001                        10000000001                    10000000001        
               1000000001                        10000000001                    10000000001        
               1000000001                        10000000001                    10000000001        
               1000000001                        10000000001                    1000000001         
               100000000111111111111111111111111110000000001                    1000000001         
               100000000000000000000000000000000000000000001                   10000000001         
               100000000000000000000000000000000000000000001                   10000000001         
               100000000000000000000000000000000000000000001                   10000000001         
               100000000000111000000000000000000000000000001                   1000000001          
               100000000000101000000000000000000000000000001                   1000000001          
               11111111111111 111111110000000000011111111111                   11000000001          
                                     1000000000001                            10000000001
                                     1000000000001                            1000000001           
                                     1000000000001                            1000000001           
                                     1000000000001                            1000000001           
                                     1000000000001                           10000000001           
                                     1000000000001                           10000000001           
                                     1000000000001                           1000000001            
                                     1000000000001                           1000000001            
                                     1000000000001                           1000000001            
                                     1000000000001                          10000000001            
                                     1000000000001                          10000000001            
                                     1000000000001                          1000000001             
                                     1000000000001                          1000000001             
                                     1000000000001                          1000000001             
                                     1000000000001                         10000000001             
                                     1000000000001                         10000000001             
                                     1000000000001                         1000000001              
                                     1000000000001                         1000000001              
                                     1000000000001                         1000000001              
                                     1000000000001                        10000000001              
                                     1000000000001                        1000000001               
                                     1000000000001                        1000000001               
                                     1000000000001                        1000000001               
                                     1000000000001                       10000000001               
                                     1000000000001                       10000000001               
                                     1000000000001                       1000000001                
                                     1000000000001                       1000000001                
                                     1000000000001                       10000000011111111111111111
                                     1000000000001                      100000000000000000000000001
                                     1000000000001                      100000000000000000000000001
                                     1000000000001                      100000000000000000000000001
                                     1000000000001                      100000000000000000000000001
                                     1000000000001                      100000000000000000000000001
                                     1000000000001                     1000000000000000000000000001 
                                     1111111111111                     1000000000000000000000000001
                                                                       1111111111111111111111111111 
															





















