NO  ./assets/textures/wall_N.xpm
SO  ./assets/textures/wall_S.xpm
WE  ./assets/textures/wall_W.xpm
EA  ./assets/textures/wall_E.xpm

C 255,255,255
F 255,0,0

 1111111111  1111111111111111111111111111111111111111111111
 1000000001111000000001000000000000000000000000000000000001
 1E00000000000001000011011101001000000000000000000000000011
 1000000001111000000000010000000000000000000000100000000011
 1111111111  1111111111111111111111111111111111111111111111