NO  ./assets/textures/brick_128x128.xpm
SO  ./assets/textures/blue_stone_64x64.xpm
WE  ./assets/textures/grey_stone_64x64.xpm
EA  ./assets/textures/wood_128x128.xpm

C 255,255,255
F 255,0,0

 1111111111  1111111111111111111111111111111111111111111111
 1000000001111000000001000000000000000000000000000000000001
 1E00000000000001000011011101001000010000000000000000000011
 1000000001111000000000010000000000000000000000100000000011
 1111111111  1111111111111111111111111111111111111111111111