NO  ./assets/textures/wall_N.xpm
SO  ./assets/textures/wall_S.xpm
WE  ./assets/textures/wall_W.xpm
EA  ./assets/textures/wall_E.xpm

C 255,255,255
F 255,0,0







111
101
111


1111111
1111111
10000W1
1111111










