NO  ./assets/textures/wall_N.xpm
SO  ./assets/textures/wall_S.xpm
WE  ./assets/textures/wall_W.xpm
EA  ./assets/textures/wall_E.xpm

C 255,255,255
F 255,0,0

	1111111111  1111111111111111111111111111111111111111111111
	1000000001  1000000001100000000000000000000000000000000001
	1000S0000111100000001  111010010000000000000000000000000011
	1000000001  10000000011100100000000000000000000100000000011
	1111111111  111111111111111111111111111111111111111111111




11111
11011
11111