NO  ./assets/textures/wall_N.xpm
SO  ./assets/textures/wall_S.xpm
WE  ./assets/textures/wall_W.xpm
E A  ./assets/textures/wall_E.xpm

C 255,255,255
F 255,0,0

	1111111111	11111111111111111111111111111111111111111111111   
	1000000001	10000000001000100000000000000000000000000000001
	1000000001	10000000001000100000000000000000000000000000001 
	1000000001	10000000001000100000000000000000000W00000000011
	1111111111	11111111111111111111111111111111111111111111111