NO  ./assets/textures/wall_N.xpm
SO  ./assets/textures/wall_S.xpm
WE  ./assets/textures/wall_W.xpm
EA  ./assets/textures/wall_E.xpm

F 225,0,0 
C 255,255,255

               11111111111111111111111111111111111111111111111111111111111111111                   
               10000000000000000000000000000000000000000000000000000000000000001                   
               10000000000000000000000000000000000000000000000000000000000000001                   
               10000000000000000000000000000000000000000000000000000000000000001                   
               10000000000000000000000000000000000000000000000000000000000000001                   
               10000000000000000000000000000000000000000000000000000000000000001                   
               10000000000000000000000000000000000000000000000000000000000000001                   
               10000000000000000000000000000000000000000000000000000000000000001                   
               10000000000000000000000000000000000000000000000100000000000000001                   
               10000000000000000000000000000000000000000000000000000000000000001                   
               10000000000000000000000000000000000000000000000000000000000000001                   
               10000000000000000000000000000000000000000000000000000000000000001                   
               10000000000000000000000000000000000000000000000000000000000000001                   
               10000000000000000000000000000000000000000000000000000000000000001                   
               10000000000000000000000000000000000000000000000000000000000000001                   
               10000000000000000000000000000000000000000000000000000000000000001                   
               10000000000000000000000000000000000000000000000000000000000000001                   
               10000000000000000000000000001000000000000000000000000000000000001                   
               10000000000000000000000000000000000000000000000000000000000000001                   
               10000001000000000000000000000000000000000000000000000000000000001                   
               10000001000000000000000000000000000000000000010000000000000000001                   
               10000001000000000000000000000000000000000000000000000000000000001                   
               10000000000000000000000000000E00000000000000000000000000000000001                   
               10000000000000000000000000000000000000000000000000000000000000001                   
               10000000000000000000000000000000000000000000000000000000000000001                   
               10000000000000000000000000000000000000000000000000000000000000001                   
               10000000000000000000000000000000000000000000000000000000000000001                   
               10000000000000000000000000000000000000000000000000000000000000001                   
               10000000000000000000000000001000000000000000000000000000000000001                   
               10000000000000000000000000000000000000000000000000000000000000001                   
               10000000000000000000000000000000000000000000000000000000000000001                   
               10000000000000000000000000000000000000000000000000000000000000001                   
               10000000000000000000000000000000000000000000000000000000000000001                   
               10000000000000000000000000000000000000000000000000000000000000001                   
               10000000000000000000000000000000000000000000000000000000000000001                   
               10000000000000000000000000000000000000000000000000000000000000001                   
               10000000000000000000000000000000000000000000000000000000000000001                   
               10000000000000000000000000000000000000000000000000000000000000001                   
               10000000000000000000000000000000000000000000000000000000000000001                   
               10000000000000000000000000000000000000000000000000000000000000001                   
               10000000000000000000000000000000000000000000000000000000000000001                   
               10000000000000000000000000000000000000000000000000000000000000001                   
               10000000000000000000000000000000000000000000000000000000000000001                   
               10000000000000000000000000000000000000000000000000000000000000001                   
               10000000000000000000000000000000000000000000000000000000000000001                   
               10000000000000000000000000000000000000000000000000000000000000001                   
               11111111111111111111111111111111111111111111111111111111111111111                   
                                                                                                   
                                                                                                   
                                                                                                   
                                                                                                   
                                                                                                   
                                                                                                   
                                                                                                   
                                                                                                   
                                                                                                   
                                                                                                   
                                                                                                   
                                                                                                   
                                                                                                   
                                                                                                   
                                                                                                   
                                                                                                   
                                                                                                   
                                                                                                   
                                                                                                   
                                                                                                   
                                                                                                   
                                                                                                   
                                                                                                   
                                                                                                   
                                                                                                   
                                                                                                   
                                                                                                   
                                                                                                   
                                                                                                   
                                                                                                   
                                                                                                   
                                                                                                   
                                                                                                   
                                                                                                   
                                                                                                   
                                                                                                   
                                                                                                   
                                                                                                   
