NO  ./textures/test_north.ppm
SO  ./textures/test_south.ppm
WE  ./textures/test_west.ppm
EA  ./textures/test_east.ppm

F 220,100,0


                                                   11111111111111111                               
                                                   10000000000000001                               
                                                   10000000000000001                               
                111111111111111                    10001111111111001                               
                100000000000001                    10001000000001001                               
                100000000000001                    10001000000001001                               
                100000000000001                    10001000000001001                               
                100000000000001                    10001000000001001                               
                101100000000001                    10001000000001001                               
                100100000000001                    10001000000001001                               
                100110000000001                    10001000000001001                               
                100011000000001                    10001000000001001                               
                100001100000001                    10001000000001001               11111           
                100000110000001                    10000000000001001               10001           
                100000011000001                    11111111111111001               10001           
                100000001100001                    10000000000000001               10001           
                100000000011001                    10000000000000001               10001           
                100000000001101                    10000000000000001               1000111111      
                1000000000000111111111111111111111110000000000000001               1000000001      
                10000000000011000000000000000000000000000000S00000011111111111111111000000001      
                10000000000100000000000000000000000000000000000000000000000000000000000000001      
                10000000001000000000000000000000000000000000000000000000000000000000000000001      
                10000000111000111111111111111111111100000000000000000000000000000000000000001      
                100000011000001                    100000000000000011111111111111111000111111      
                100000010000001                    10000000000000001               10001           
                100000110000001                    10000000000000001               10001           
                100011100000001                    10000000000000001               10001           
                100010000000001                    10000000000000001               10001           
                100110000000001                    10000000000000001               10001           
                101100000000001                    10000000000000001               10001           
                101000000000001                    10000000000000001               11111           
                100000000000001                    10000000000000001                               
                100000000000001                    10000000000000001                               
                100000000000001                    10000000000000001                               
                111111111111111                    10000000000000001                               
                                                   10000000000000001                               
                                                   11111111111111111                               

C 225,30,0 
